ask sb. to do sth. ==要求某人做某事
ask sb not to do ==要求某人不要做某事 
allow sb to do sth ==允许某人做某事 
sb be allowed to do sth ==某人被允许做某事  
forget to do == 忘记要去做某事 
forget doing sth ==忘记做过某事
too...to ==太...以至于不能 
remember to do ==记得要去做某事
remember doing sth ==记得做过某事 
It is adj. for sb to do sth == 必考句型
tell sb to do sth ==让某人做某事
tell sb not to do sth ==让某人不要做某事
stop doing sth ==停止正在做的事情
stop to do sth ==停下来去做另外一件事
want sb to do sth == 想某人做某事
agree to do sth ==同意做某事
go on doing sth ==继续做某事（同一件事）
go on to do sth ==继续做某事（另一件事）
had better do sth ==最好去做某事
had better not do sth ==最好不要做某事 
why not do sth? ==为什么不做某事
prefer to do rather than do sth ==宁愿做某事，也不愿做...
apartment ==公寓
travel ==旅行
arrive ==到达
hear from ==收到...来信
used to ==过去常常
give up ==放弃
dress == 穿衣
popular ==流行的，受欢迎的
take part in ==参加
enter ==进入
offer ==提供
lonely ==孤独
alone ==独自
drop ==滴
satisfied ==满意的
excited ==兴奋地
be interested in ==对...感兴趣
look forward to ==盼望
North China ==华北
almost/nearly ==几乎，将近 
parents-in-law ==岳父母 
accident ==事故
pollution ==污染
shout ==喊叫 
wish ==希望 
person ==人 
even ==甚至 
surprised ==吃惊的 
injured ==受伤的 
comfortable ==舒服的 
cure ==治愈 
believe ==相信 
find out ==找出，弄明白 
pleasure ==愉快 
No problem ==没问题 
an hour’s drive ==开车一小时的路程 
understand ==明白，理解 
an old friend of mine ==我的一位老友 
result ==结果 
the whole day ==一整天 
easily ==容易地 
spend ==花费 
how long ==多长时间 
miss ==错过，想念 
finish ==完成 
square ==正方形，广场 
until ==直到 
not…until ==直到…时候才 
centre ==中心 
be located ==位于 
cover ==覆盖 
as soon as ==一…就… 
sometimes ==有时 
remember ==记得 
forget ==忘记 
works ==作品 
grab ==抓住 
perfectly ==完美地 
ninth ==第九 
husband ==丈夫 
exhibition ==展览 
rubbish ==垃圾 
mouse ==老鼠 
floor ==楼层 
although ==尽管，虽然 
against ==反对 
the day before yesterday ==前天 
the day after tomorrow ==后天 
admit ==承认 
manager ==经理 
clerk ==职员 
difficult ==困难的 
frightened ==害怕的 
explain ==解释 
the barker’s ==理发店 
during ==在…期间 
have sb’s hair cut ==理发 
argue ==争论 
enough ==足够 
rule ==规则 
office time ==办公时间 
exchange student ==留学生 
honest ==诚实的 
completely ==完全地 
empty ==空的 
information ==信息 
professor ==教授 
exam/examination ==考试 
a few days ==几天 
study ==学习 
go sightseeing ==去观光 
angry ==生气的 
however ==然而 
appear ==出现 
far away from ==远离 
fail ==失败，不及格 
Never mind ==不要紧 
holiday ==假日 
handsome ==潇洒的 
greet ==问候 
concert ==音乐会 
gloves ==手套 
science fiction ==科幻 
since ==自从 
own ==自己的 
in front of ==在…的前面 
nobody ==没有人 
while ==当…的时候 
beer ==啤酒 
musical instrument ==乐器 
nearby ==附近 
sadly ==悲伤地 
pay ==付钱 
behind ==在…的后面 
shop assistant ==营业员 
surf the internet ==上网 
terrible ==可怕的 
grape ==葡萄 
taste ==尝起来 
another ==另一个 
look for ==寻找 
look after ==照顾，照料 
think of ==考虑 
salty ==咸的 
three times ==三次 
poor ==可怜的，穷的 
expensive ==贵的 
parents ==父母 
type ==型号 
same ==同样的 
different ==不同的 
hospital ==医院 
operation ==手术 
daytime ==白天 
usually ==通常 
unpleasant ==不愉快 
always ==总是 
already ==已经 
weak ==弱的 
recognize ==认出 
dangerous ==危险的 
intention ==目的 
complain ==抱怨 
health ==健康 
experience ==经历 
idea ==主意 
trip ==旅行 
language ==语言 
advice ==建议 
interesting ==有趣的 
junior middle school ==初中 
senior middle school ==高中 
important ==重要的 
bored ==感到无聊的 
check ==检查 
boiled water ==开水 
room ==空间 
because ==因为 
nurse ==护士 
sickness ==病 
department store ==百货商店 
foolish ==愚蠢的 
cheat ==欺骗 
metro station ==地铁站 
ask for help ==请求帮助 
steal ==偷 
entrance ==入口 
museum ==博物馆 
bank ==银行 
except ==除了 
healthy ==健康的 
the first time ==第一次 
be afraid of ==害怕 
get back home ==回到家 
without ==没有 
physical ==身体的 
fresh ==新鲜的 
plenty of ==大量的 
enjoy oneself ==过得愉快 
hold on ==请稍后，别挂断 
happen ==发生 
give…back ==还 
get…back ==取 
finally ==最后 
talk about ==讨论 
maths ==数学 
together ==一起 
birthday present ==生日礼物 
above ==在…上方 
pocket money ==零花钱 
do one’s best ==尽某人最大努力 
visitor ==游客 
care ==关心 
get along with ==与…相处 
worry ==担心 
beside ==在…旁边 
besides ==除…之外，还有 
reason ==理由 
beautiful ==漂亮的 
seldom ==很少 
never ==从来不 
corner ==角落 
restaurant ==饭店 
deaf ==聋的 
impossible ==不可能的 
make friends ==交朋友 
pop song ==流行歌曲 
laugh ==大笑 
dolphin ==海豚 
friendly ==友好的 
this coming Sunday ==这个星期天 
discussion ==讨论 
topic ==话题 
improve ==提高 
be able to ==能够 
furniture ==家具 
decide ==决定 
country ==国家 
leave ==离开 
government ==政府 
company ==公司 
future ==将来 
more than ==超过 
mainly ==主要 
international ==国际的 
the United States ==美国 
cousin ==表（堂）兄弟（姐妹） 
university ==大学 
local ==当地的 
history ==历史 
provide ==提供 
past ==过去 
learn about ==了解 
be not sure ==不肯定 
juicy ==多汁的 
food processor ==食品加工器 
strawberry ==草莓 
harmful ==有害的 
trouble ==麻烦 
last night ==昨天晚上 
sugar ==白糖 
town ==镇 
village ==村庄 
careless ==粗心的 
shopkeeper ==店主 
patient ==耐心的 
musician ==音乐家 
daughter ==女儿 
story ==层 
the same as ==和…一样 
violinist ==小提琴家 
ten minutes’ walk ==十分钟步行的路程 
free time ==空闲时间 
fearful ==恐怖的 
realize ==意识到 
flight ==飞行 
tennis ==网球 
nationality ==国籍 
height ==高度 
set up ==建立 
nervous ==紧张的 
confident ==自信的 
mud ==泥 
kid ==小孩 
symbol ==象征 
pork ==猪肉 
scratch ==抓 
TV program ==电视节目 
suppose ==设想 
midnight ==半夜 
stay up ==熬夜 
successful ==成功的 
high school ==高中 
weekend ==周末 
be different from ==与…不同 
get puzzled ==感到迷惑 
player ==选手 
team ==队伍 
from time to time ==时常 
goal ==目标，进球 
warm-hearted ==热心的 
mop the floor ==拖地 
key ==钥匙 
everywhere ==到处 
modern ==现代的 
grow up ==长大 
physical exercise ==体育锻炼 
Canada ==加拿大 
mountain ==大山 
skillful ==有技能的 
humorous ==幽默的 
persuade ==劝说 
altogether ==总共 
European ==欧洲的 
Europe ==欧洲 
play the piano ==弹钢琴 
chopsticks ==筷子 
close ==亲密的 
trust ==信任 
president ==总统 
money ==钱 
maybe ==也许 
hotel ==宾馆 
bathroom ==浴室 
tour ==旅行 
be famous for ==以…而闻名 
south-west ==西南 
return ==回来 
bedroom ==卧室 
percentage ==百分比 
excellent ==极好的 
television ==电视 
service ==服务 
Germany ==德国 
publish ==出版 
fact ==事实 
several ==几个 
Austrian ==奥地利人 
public ==公众 
parcel ==包裹 
well-known ==众所周知的 
pack ==包装 
address ==地址 
post ==寄 
weight ==重 
cause ==引起 
magazine ==杂志 
habit ==习惯 
practice ==练习 
medicine ==药 
dizzy ==头晕的 
movement ==移动 
subway ==地铁 
form ==养成 
as well as ==还有 
eye exercises ==眼保健操 
drugstore ==药店 
fantastic ==美妙的 
show sb. around ==带领某人参观 
wonderful ==精彩的 
cabbage ==卷心菜 
bother ==麻烦 
agree with sb. ==同意某人的意见 
dictionary ==字典 
get up ==起床 
housework ==家务劳动 
within ==在…以内 
deep ==深的 
favorite ==最喜欢的 
recently ==最近 
lately ==最近 
do shopping ==购物 
reach ==到达 
outdoor ==户外 
indoor ==室内 
both ==两者都 
be good at ==擅长 
difficulty ==困难 
not only…but also ==不但…而且 
single ==单一的 
nowadays ==如今 
dream ==梦 
hamburger ==汉堡包 
snack ==零食，小吃 
backyard ==后院 
prepare ==准备 
barbecue ==烧烤 
cheese ==奶酪 
lettuce ==生菜 
tomato ==西红柿 
onion ==洋葱 
garlic ==大蒜 
nothing ==没有东西 
business ==生意 
teenager ==青少年 
author ==作者 
have a good time ==玩的愉快 
sunny ==晴朗的 
classmate ==同班同学 
because of ==因为 
tent ==帐篷 
store-room ==储藏室 
liquid ==液体 
basket ==篮子 
announcement ==公告 
passenger ==乘客 
destination ==终点 
lantern ==灯笼 
dragon ==龙 
countryside ==乡村 
go to the cinema ==去电影院 
crowded ==拥挤的 
cigarette ==香烟 
become ==成为 
invite ==邀请 
sign ==标记 
the Eiffel Tower ==埃菲尔铁塔 
step ==楼梯 
thousands of ==数千的 
all over the world ==全世界 
suggest ==建议 
cost ==花费，值 
how often ==多久一次 
electric light ==电灯 
a large number of ==大量 
begin ==开始 
half a year ==半年 
ostrich ==鸵鸟 
swallow ==燕子 
eagle ==鹰 
squirrel ==松鼠 
van ==有蓬卡车 
possible ==可能的 
ambulance ==救护车 
fetch ==取 
lay ==平放 
worry about ==担心 
get rid of ==去除，摆脱 
protect ==保护 
face ==面对 
Christmas ==圣诞节 
receive ==收到 
accept ==接受 
stranger ==陌生人 
newspaper ==报纸 
simple ==简单的 
body language ==身体语言 
notice ==注意 
fat ==脂肪 
weight ==重量 
choice ==选择 
French fries ==炸薯条 
beef ==牛肉 
vegetable ==蔬菜 
kitchen ==厨房 
pizza ==披萨 
sandwich ==三明治 
danger ==危险 
library ==图书馆 
market ==市场 
supermarket ==超市 
post office ==邮局 
refrigerator ==冰箱 
soup ==汤 
death ==死 
treat ==对待 
pity ==遗憾 
hardly ==几乎不 
neither…nor… ==既不…也不… 
burn ==燃烧 
subject ==科目 
microwave oven ==微波炉 
train ==训练 
band ==乐队 
pronounce ==发音 
attention ==注意 
age ==年龄 
strange ==奇怪的 
reader ==读者 
either ==也（否定句） 
suddenly ==突然 
spell ==拼写 
fare ==车票 
waggle ==摆动 
temple ==寺庙 
honor ==纪念，荣誉 
traditional ==传统的 
seaside ==海边 
celebrate ==庆祝 
special ==特别的 
wooden ==木头的 
message ==消息 
mobile phone ==手机 
twin ==双胞胎 
earthquake ==地震 
price ==价格 
metal ==金属 
else ==别的 
journey ==旅行 
the Grand Theatre ==大剧院 
change ==变化 
stepmother ==继母 
collect stamps ==集邮 
prefer ==更喜欢 
repair ==修理 
branch ==树枝 
stem ==茎 
put off ==取消 
work out ==算出 
solve ==解决 
cleaner ==清洁工 
wide ==宽的 
plan ==计划 
client ==客户 
interest ==兴趣 
invent ==发明 
literature ==文学 
memory ==记忆 
poem ==小诗 
machine ==机器 
measure ==测量，措施 
take a shower ==洗澡 
weather ==天气 
success ==成功 
performance ==表演 
useful ==有用的 
take good care of ==好好照顾 
unlucky ==不幸的 
peony ==牡丹 
turtle ==海龟 
tulip ==郁金香 
snail ==蜗牛 
carnation ==康乃馨 
lotus ==莲花 
imagine ==想象 
blood ==血 
the Palace Museum ==故宫 
the Summer Palace ==颐和园 
the Great Wall ==长城 
professional ==专业的 
artist ==画家 
assignment ==作业 
uninteresting ==无聊的 
wheel ==轮子 
impress ==给…深刻的印象 
this way ==这边走 
movie ==电影 
police station ==警察局 
factory ==工厂 
raincoat ==雨衣 
plant ==植物 
clinic ==诊所 
describe ==描述 
cycle ==骑车 
match ==配对 
fit ==适合 
chat ==聊天 
private ==私人的 
district ==区 
perfect ==完美的 
dark ==黑暗的 
eager ==渴望 
serious ==严重的 
take a rest ==休息一下 
blood pressure ==血压 
temperature ==温度 
paragraph ==段落 
necessary ==必要的 
develop ==发展 
energy ==能量 
through ==通过 
scientist ==科学家 
camera ==照相机 
tube ==管子 